1111111111
1111111111
1111111111
1111111111
1111111111
1P00C00011
1000C00E11
1111111111