1111111
100P001
1001001
100C001
1000001
10B0E01
1000001
1111111
