1111111
100P001
1000001
1000001
1000001
1000001
100C0E1
1111111
